1111111111111111111111111111111111111111111111111111111111111111111111111111111111111111111111111111
0000000000000000000000000000000000000000000000000000000000000000000000000000000000000000000000000000
0000000000000000000000000000000000000000000000000000000000000000000000000000000000000000000000000000
0000011111111111111111100000000000000000000000000000000000000000000000000000000000000000000000000000
0000010000000000000000100000000000000000000000000000000000000000000000000000000000000000000000000000
0000010000000000000000100000000000000000000000000000000000000000000000000000000000000000000000000000
0000111111101111111000100000000000000000000000000000000000000000000000000000000000000000000000000000
0000100010101111111000100000000000000000000000000000000000000000000000000000000000000000000000000000
0000100010101101011000100000000000000000000000000000000000000000000000000000000000000000000000000000
0000101000101000001000100000000000000000000000000000000000000000000000000000000000000000000000000000
0000100000101000001000011111111111111111111111111111111111111111111111111111111111111111110000000000
0000111111101000001000000000000000000000000000000000000000000000000000000000000000000000010000000000
0000111000101011111000000000000000000000000000000000000000000000000000000000000000000000010000000000
0000110000101111111000000000000000000000000000000000000000000000000000000000000000000000010000000000
0000111000100000001000000000000000000000000000000000000000000000000000000000000000000000010000000000
0000110001100000000000000000000000000000000000000000000000000000000000000000000000000000010000000000
0000111001100000001000000000000000000000000000000000000000000000000000000000000000000000010000000000
0000111111111111111000000000000000000000000000000000000000000000000000000000000000000000010000000000
0000000000000000000000000000000000000000000000000000000000000000000000000000000000000000010000000000
0000010000000000000000000000000000000000000000000000000000000000000000000000000000000000010000000000
0000010000000000000000000000000000000000000000000000000000000000000000000000000000000000010000000000
0000010000000000000000000000000000000000000000000000001111100000000000000000000000000000010000000000
0000010000000000000000000000000000000000000000000000001110100000000000000000000000000000010000000000
0000010000000000000000000000000000000000000000000000001110100000000000000000000000000000010000000000
0000011111111110000000000000000000011111111111111111001000100000000000000000000000000000010000000000
0000011110000010000000000000000000010111101111111111001000100000000000000000000000000000010000000000
0000011110000010000000000000000000010000001110111111001111111110000000000000000000000000010000000000
0000011110011010000000000000000000011100111100111101001000011110000000000000000000000000010000000000
0000011110011010000000000000000000011100111100100001001000010110000000000000000000000000010000000000
0000011000000010000000000000000000011100111100100001001110000010000000000000000000000000010000000000
0000011111111110000000000000000000011100111110111011001111000010000000000000000000000000010000000000
0000010000000000000000000000000000011100111100000001001111000010000000000000000000000000010000000000
0000010000000000000000000000000000010000001100000001001110001110000000000000000000000000010000000000
0000010000000000000000000000000000011110111111111111001111111110000000000000000000000000010000000000
0000010000000000000000000000000000000000000000000000000000000000000000000000000000000000010000000000
0000010000000000000000000000000000000000000000000000000000000000000000000000000000000000010000000000
0000010111111111110000000000000000000000000000000000000000000000000000000000000000000000010000000000
0000010110110110010000000000000000000000000000000000000000000000000000000000000000000000010000000000
0000010110110110010000000000000000011000000000000100000000000000000000000000000000000000010000000000
0000010100100100010000000000000000011111111111111111111111000111111110000000000000000000010000000000
0000010100100100010000000000000000010001001001000110000001000100111110000000000000000000010000000000
0000010111111110110000000000000000010001001001000110000001000101111110000000000000000000010000000000
0000010100000100010000000000000000010001000001000110000001000101111110000000000000000000010000000000
0000010100000000010000000000000000011111111111111111111111000100111110000000000000000000010000000000
0000010111110100010000000000000000000011111111011111100000000111000010000000000000000000010000000000
0000010111110100010000000000000000000011111111011101100000000111111110000000000000000000010000000000
0000010111110100010000000000000000000011011001011000100000000111111110000000000000000000010000000000
0000010111110100010000000000000000000010001001011000100000111111110000000000000000000000010000000000
0000010100000100010000000000000000000010001001011100100000101011110000000000000000000000010000000000
0000010111111111110000000000000000000011011001011111100000101011110000000000000000000000010000000000
0000010000000000000000000000000000000010011111011100100000100000010000000000000000000000010000000000
0000010000000001111111100000000000000011111111010100100000111111110000000000000000000000010000000000
0000010000000001110100111111110000000000000000011110100000100000010000000000000000000000010000000000
0000010000000001100000111111010000000111111110010100100000100000110000000000000000000000010000000000
0000010000000001000100111100010000000111111110010000100000100001110000000000000000000000010000000000
0000010000000001110111100000010000000101101010011111100000100011010000000000000000000000010000000000
0000010000000001010000111111010000000100100010000000000000111111110000000000000000000000010000000000
0000010000000001111100100001010000000100100010000000000000000000000000000000000000000000010000000000
0000010000000001111101111101111110000111111110000000000000000000000000000000000000000000010000000000
0000010000000001111111101001011110000000000010000000000000000000000000000000000000000000010000000000
0000010000000000000000001001000110000111111110000000000000000000000000000000000000000000010000000000
0000010000000000000000001001000110000111000110000000000000000000000000000000000000000000010000000000
0000010000000000000000001001111110000110000110000000000000000000000000000000000000000000010000000000
0000011111111111111100001001000010000111111110000000000000000000000000000000000000000000010000000000
0000011111111010000100001001000010000000000000000000000000000000000000000000000000000000010000000000
0000011111111000000100001111111110000000000000000000000000000000000000000000000000000000010000000000
0000011000000010000100001011010010000000000000000000000000000000000000000000000000000000010000000000
0000011111111110000100001111111010000000000000000000000000000000000000000000000000000000010000000000
0000011101010110000100001111111110000000000000000000000000000000000000000000000000000000010000000000
0000011101010110000100001111111110000000000000000000000000000000000000000000000000000000010000000000
0000011100000010000100000000000000000000000000000000000000000000000000000000000000000000010000000000
0000011111100000000100000000000000000000000000000000000000000000000000000000000000000000010000000000
0000011000100011111100000000000000000000000000000000000000000000000000000000000000000000010000000000
0000011000111110000100000000000000000000000000000000000000000000000000000000000000000000010000000000
0000011000000000000000000000000000000000000000000000000000000000000000000000000000000000010000000000
0000011110000000000000000000000000000000000000000000000000000000000000000000000000000000010000000000
0000011110011110000000000000000000000000000000000000000000000000000000000000000000000000010000000000
0000011000100011111100000000000000000000000000000000000000000000000000000000000000000000010000000000
0000011111100010000100000000000000000000000000000000000000000000000000000000000000000000010000000000
0000011000000010000100000000000000000000000000000000000000000000000000000000000000000000010000000000
0000011001111010000100000000000000000000000000000000000000000000000000000000000000000000010000000000
0000011111111110000100000000000000000000000000000000000000000000000000000000000000000000010000000000
0000011111111110000100000000000000000000000000000000000000000000000000000000000000000000010000000000
0000011001111010000100000000000000000000000000000000000000000000000000000000000000000000010000000000
0000011000000010000100000000000000000000000000000000000000000000000000000000000000000000010000000000
0000011111111111111100000000000000000000000000000000000000000000000000000000000000000000010000000000
0000010000000000000000000000000000000000000000000000000000000000000000000000000000000000010000000000
0000010000000000000000000000000000000000000000000000000000000000000000000000000000000000010000000000
0000010000000000000000000000000000000000000000000000000000000000000000000000000000000000010000000000
0000011111111111111111111111111111111111111111111111111111111111111111111111111111111111110000000000
0000000000000000000000000000000000000000000000000000000000000000000000000000000000000000000000000000
0000000000000000000000000000000000000000000000000000000000000000000000000000000000000000000000000000
0000000000000000000000000000000000000000000000000000000000000000000000000000000000000000000000000000
0000000000000000000000000000000000000000000000000000000000000000000000000000000000000000000000000000
0000000000000000000000000000000000000000000000000000000000000000000000000000000000000000000000000000
0000000000000000000000000000000000000000000000000000000000000000000000000000000000000000000000000000
0000000000000000000000000000000000000000000000000000000000000000000000000000000000000000000000000000
0000000000000000000000000000000000000000000000000000000000000000000000000000000000000000000000000000
0000000000000000000000000000000000000000000000000000000000000000000000000000000000000000000000000000
0000000000000000000000000000000000000000000000000000000000000000000000000000000000000000000000000000
